Adele - Rolling In The Deep 
Amy Winehouse - Rehab 
Coldplay - Clocks 
Coldplay - Viva La Vida 
Kate Perry - I Kissed A Girl 
Kelis - Trick Me 
Madonna - Beautiful Stranger 
Nelly Furtado - Forca 
Nickelback - This Afternoon 
Nirvana - Smells Like Teen Spirit
Norah Jones - Sunrise 
The Doors - Love Me Two Times 
Toto - Africa 
Rihanna - umbrella

Avercage - Embers
Color Out - Falling Star
Cortez - Feel  Stripped 
Explosive Ear Candy - Like The Sun
HILA - Give Me the Same
JASON MILLER - CROWD PLEASER
Kinematic - Peyote
Lower Loveday - Is It Right 
LUNABLIND - Vision  Radio Edit 
Moon I Mean - Wrong Concept
Pure Mids - The Leader
Quentin Hannappe - Keep On
Ridgway - Fire Inside
Rxbyn - Bad Side
Slingshot Miracle - Whistler
Songwriterz - Back In Time
The.madpix.project - One Way Street
The Rinn - Voices
Tom Orlando - The One
Wordsmith - The Statement

Abba - Knowing Me Knowing You
Bangles - Eternal Flame
Blondie - Call Me
Duffy - Warwick Avenue
Duran Duran - Ordinary World
Franz Ferdinand - Do You Want To
Martika - Toy Soldiers
Muse - Guiding Light
Otis Redding - The Dock Of The Bay
Shinya Iguchi - Once In ALife Time
Shinya Iguchi - Someday
Queen - We Are The Champions
Robert Palmer - Addicted To Love
Santana - Black Magic Woman
Simon And Garfunkel - Cecilia
Take That - Back For Good
Tina Turner - Whats Love Got To Do With It
Toto - Africa
U2 - With Or Without You
Zweieck - She

